0000,0000,0000,0000,0000,0000,0000,0000,0000,0000,0000,0000,0000
0000,0000,0000,0000,0000,0000,0000,0000,0000,0000,0000,0000,0000
0000,0000,0000,1201,0000,0000,0000,0000,0000,1201,0000,0000,0000
0000,0000,0000,1201,0000,0000,0000,0000,0000,1201,0000,0000,0000
0000,0000,0000,0000,1201,0000,0000,0000,1201,0000,0000,0000,0000
0000,0000,0000,0000,1201,0000,0000,0000,1201,0000,0000,0000,0000
0000,0000,0000,2002,2002,2002,2002,2002,2002,2002,0000,0000,0000
0000,0000,0000,2002,2002,2002,2002,2002,2002,2002,0000,0000,0000
0000,0000,2002,2032,0902,2002,2002,2002,0902,2002,2002,0000,0000
0000,0000,2002,2002,0902,2042,2002,2002,0902,2002,2002,0000,0000
0000,2002,2002,2002,2002,2052,2002,2002,2002,2002,2002,2002,0000
0000,2002,2002,2022,2002,2002,2002,2002,2002,2002,2002,2002,0000
0000,2002,2012,2002,2002,2002,2002,2002,2002,2002,2002,2002,0000
0000,2002,0000,2002,2002,2002,2002,2002,2002,2002,0000,2002,0000
0000,2002,0000,2002,0000,0000,0000,0000,0000,2002,0000,2002,0000
0000,2002,0000,2002,0000,0000,0000,0000,0000,2002,0000,2002,0000
0000,0000,0000,0000,2002,2002,0000,2002,2002,0000,0000,0000,0000
0000,0000,0000,0000,2002,2002,0000,2002,2002,0000,0000,0000,0000
0000,0000,0000,0000,0000,0000,0000,0000,0000,0000,0000,0000,0000
0000,0000,0000,0000,0000,0000,0000,0000,0000,0000,0000,0000,0000
0000,0000,0000,0000,0000,0000,0000,0000,0000,0000,0000,0000,0000
0000,0000,0000,0000,0000,0000,0000,0000,0000,0000,0000,0000,0000
0000,0000,0000,0000,0000,0000,0000,0000,0000,0000,0000,0000,0000
0000,0000,0000,0000,0000,0000,0000,0000,0000,0000,0000,0000,0000
0000,0000,0000,0000,0000,0000,0000,0000,0000,0000,0000,0000,0000
0000,0000,0000,0000,0000,0000,0000,0000,0000,0000,0000,0000,0000
0000,0000,0000,0000,0000,0000,0000,0000,0000,0000,0000,0000,0000
0000,0000,0000,0000,0000,0000,0000,0000,0000,0000,0000,0000,0000
0000,0000,0000,0000,0000,0000,0000,0000,0000,0000,0000,0000,0000
0000,0000,0000,0000,0000,0000,0000,0000,0000,0000,0000,0000,0000
0000,0000,0000,0000,0000,0000,0000,0000,0000,0000,0000,0000,0000
0000,0000,0000,0000,0000,0000,0000,0000,0000,0000,0000,0000,0000
0000,0000,0000,0000,0000,0000,0000,0000,0000,0000,0000,0000,0000
0000,0000,0000,0000,0000,0000,0000,0000,0000,0000,0000,0000,0000
0000,0000,0000,0000,0000,0000,0000,0000,0000,0000,0000,0000,0000
0000,0000,0000,0000,0000,0000,0000,0000,0000,0000,0000,0000,0000
0000,0000,0000,0000,0000,0000,0000,0000,0000,0000,0000,0000,0000
0000,0000,0000,0000,0000,0000,0000,0000,0000,0000,0000,0000,0000
0000,0000,0000,0000,0000,0000,0000,0000,0000,0000,0000,0000,0000
0000,0000,0000,0000,0000,0000,0000,0000,0000,0000,0000,0000,0000